11111111111111111111111111
1P000100001C00010C10000001
1111010C101111010110000001
10C10111101000010000001C01
1C0000C1000011111111101111
1010C000000000000000000001
11E11111111110111101111111
1000000000000011C0000000C1
11111111111111111111111111
